25 25 
300 300
3 3 3 3  3  3  3  3  3  3  3  3  3  3  3  3  3  3 3 3 3  3  3  3 3
3 2 2 2  2  2  2  2  2  2  2  2  2  2  2  2  2  2 2 2 2  2  2  2 3 
3 2 2 2  2  3  2  2  2  2  2  2  2  2  2  2  2  2 2 2 2  2  2  2 3 
3 2 2 2  3  2  2  2  2  2  2  2  2  2  2  2  2  2 2 2 2  2  3  3 3 
3 2 2 2  2  2  2  2  2  2  2  2  2  2  2  2  2  2 2 2 2  2  2  2 3 
3 2 2 2  2  2  2  2  2  2  2  2  2  2  2  2  2  2 2 2 2  2  2  2 3 
3 2 2 2  2  2  2  2  2  2  2  2  2  2  2  2  2  2 2 2 2  2  3  2 3 
3 2 2 2  2  2  2  2  2  2  2  2  2  2  2  2  2  2 2 2 2  2  2  2 3 
3 2 2 2  2  2  2 14  2  2  2  2  2  2  2  2  2  2 2 2 2  2  2  2 3 
3 2 2 2  2  2  2 14  2  2  2  2  2  2  2  2  2  2 2 2 2  2  2  2 3 
3 2 2 2 14  2  2 14  2  2  2 11  6  6  6  6  6  6 6 6 6 12  2  2 3 
3 2 2 2 14 14 14 14  2  2  2  5  4  4  4  4  4  4 4 4 4  7  2  2 3 
3 2 2 2  2  2 14  2  2  2  2  5  4  4  4  4  4  4 4 4 4  7  2  2 3 
3 2 2 2  2  2 14 14 14  2  2  5  4  4  4  4  4  4 4 4 4  7  2  2 3 
3 2 2 2  2  2  2  2 14 14 14  4  4  4  4  4  4  4 4 4 4  7  2  2 3 
3 2 2 2  2  2  2  2 14 14 14  4  4  4  4  4  4  4 4 4 4  7  2  2 3 
3 2 2 2  2  2  2  2 14  2  2  5  4  4  4  4  4  4 4 4 4  7  2  2 3 
3 2 2 2  2  2  2  2 14  2  2  5  4  4  4  4  4  4 4 4 4  7  2  2 3 
3 2 2 2  2  2  2  2 14  2  2  5  4  4  4  4  4  4 4 4 4  7  2  2 3 
3 2 2 2  2  2  2  2 14  2  2  9  8  8  8  4  4  4 8 8 8 10  2  2 3 
3 2 2 2  2  2  2  2 14 14 14 14 14 14 14 14 14 14 2 2 2  2  2  2 3 
3 2 2 2  2  2  2  2  2  2  2  2  2  2  2  2  2  2 2 2 2  2  2  2 3 
3 2 2 2  2  2  2  2  2  2  2  2  2  2  2  2  2  2 2 2 2  2  3  3 3 
3 2 2 2  2  2  2  2  2  2  2  2  2  2  2  2  2  2 2 2 3  3  2  2 3 
3 3 3 3  3  3  3  3  3  3  3  3  3  3  3  3  3  3 3 3 3  3  3  3 3
