40 23
300 300
 1  1  1  1  1  1  1  1  1  1  1  1  1  1  1  1  1  1  1  1  1  1  1  1  1  1  1  1  1  1  1  1  1  1  1  1  1  1  1  1   
 1  0  0  0  0  0  0  0  0  0  0  0  0  0  0  0  0  0 16  0  0  0  0  0  0  0  0  0  0  0  0  0  0  0  0  0  0  0  0  0   
 1  0  0  0  0  0  0  0  0  0 16  0  0  0  0  0  0  0 16  0  0  0  0  0  0  0  0  0  0  0  0  0  0  0  0  0  0  0  0  0 
 1  0  0  0  0 16  0  0  0  0 16  0  0  0  0  0  0  0 16  0  0  0 16  0  0  0  0  0  0  0  0  0  0  0  0  0  0  0  0  0   
16 16 16 16 16 16 16 16 16 16 16 16 16 16 16 16 16 16 16 16 16 16 16 16 16  0  0  0  0  0  0  0  0  0  0  0  0  0  0  0 
 1 16 15 15 15 15 15 15 15 15 15 15 15 15 15 15 15 15 15 15 15 15 15 16 16  0  0  0  0  0  0  0  0  0  0  0  0  0  0  0  
 1 16 15 15 15 15 15 15 15 15 15 15 15 15 15 15 15 15 15 15 15 15 15 16 16  0  0  0  0  0  0  0  0  0  0  0  0  0  0  0  
 1 16 15 15 15 15 15 15 15 15 15 15 15 15 15 15 16 15 15 15 15 15 15 16 16  0  0  0  0  0  0  0  0  0  0  0  0  0  0  0 
 1 16 15 15 15 15 15 15 15 15 15 15 15 15 15 15 16 15 15 15 15 15 15 16 16  0  0  0  0  0  0  0  0  0  0  0  0  0  0  0
 1 16 15 15 15 15 15 15 15 15 15 15 15 15 15 15 16 15 15 15 15 15 15 16 16  0  0  0  0  0  0  0  0  0  0  0  0  0  0  0 
 1 16 15 15 15 15 15 15 15 15 15 15 15 15 15 15 16 15 15 15 15 15 15 16 16  0  0  0  0  0  0  0  0  0  0  0  0  0  0  0  
 1 16 15 15 15 15 15 15 15 15 15 15 15 15 15 15 16 15 15 15 15 15 15 16 16  0  0  0  0  0  0  0  0  0  0  0  0  0  0  0 
 1 16 15 15 15 15 15 15 15 15 15 15 15 15 15 15 16 15 15 15 15 15 15 16 16  0  0  0  0  0  0  0  0  0  0  0  0  0  0  0 
16 16 16 16 16 16 16 16 16 16 16 16 16 16 16 16 16 16 16 16 16 16 16 16 16  0  0  0  0  0  0  0  0  0  0  0  0  0  0  0 
 1 16 16  0  0  0  0  0  0  0  0  0  0  0  0  0  0  0  0  0 16  0  0  0  0  0  0  0  0  0  0  0  0  0  0  0  0  0  0  0  
 1 16 16  0  0 16  0  0  0  0 16 16  0  0  0 16  0  0  0  0 16  0  0  0  0  0  0  0  0  0  0  0  0  0  0  0  0  0  0  0   
 1 16 16 16 16 16 16 16 16 16 16 16 16 16 16 16 16 16 16 16 16 16 16 16  0  0  0  0  0  0  0  0  0  0  0  0  0  0  0  0 
 1 16 16  0  0  0  0  0  0  0  0  0  0  0  0  0  0  0  0  0  0  0  0 16  0  0  0  0  0  0  0  0  0  0  0  0  0  0  0  0   
 1 16 16  0  0  0  0  0  0  0  0  0  0  0  0  0  0  0  0  0  0  0  0 16  0  0  0  0  0  0  0  0  0  0  0  0  0  0  0  0
 1 16 16  0  0  0  0  0  0  0  0  0  0  0  0  0  0  0  0  0  0  0  0 16  0  0  0  0  0  0  0  0  0  0  0  0  0  0  0  0  
16 16 16 16 16 16 16 16 16 16 16 16 16 16 16 16 16 16 16 16 16 16 16 16  0  0  0  0  0  0  0  0  0  0  0  0  0  0  0  0 
 1 16 16  0  0  0  0  0  0  0  0  0 16  0  0  0  0  0  0  0  0  0  0  0  0  0  0  0  0  0  0  0  0  0  0  0  0  0  0  0   
 1  1  1  1  1  1  1  1  1  1  1  1  1  1  1  1  1  1  1  1  1  1  1  1  1  1  1  1  1  1  1  1  1  1  1  1  1  1  1  1   
 
