40 23
500 200
 1  1  1  1  1  1  1  1  1  1  1  1  1  1  1  1  1  1  1  1  1  1  1  1  1  1  1  1  1  1  1  1  1  1  1  1  1  1  1  1   
 1  0  0  0  0  0  0  0  0  0  0  0  0  0  0  0  0  0  0  0  0  0  0  0  0  0  0  0  0  0  0  0  0  0  0  0  0  0  0  0   
 1  0  0  0  0  0  0  0  0  0  0  0  0  0  0  0  0  0  0  0  0  0  0  0  0  0  0  0  0  0  0  0  0  0  0  0  0  0  0  0 
 1  0  0  0  0  0  0  0  0  0  0  0  0  0  0  0  0  0  0  0  0  0  0  0  0  0  0  0  0  0  0  0  0  0  0  0  0  0  0  0   
16 16 16 16 16 16 16 16 16 16 16 16 16 16 16 16 16 16 16 16 16 16 16 16 16 16 16 16 16 16 16 16 16 16 16 16 16 16 16 16 
15 16 15 15 15 15 15 15 15 15 15 15 15 15 15 15 15 15 15 15 15 15 15 16 16 15 15 15 15 15 15 16 16 15 15 15 15 15 16 16  
15 16 15 15 15 15 15 15 15 15 15 15 15 15 15 15 15 15 15 15 15 15 15 16 16 15 15 15 15 15 15 16 16 15 15 15 15 15 16 16  
15 16 15 15 15 15 15 15 15 15 15 15 15 15 15 15 16 15 15 15 15 15 15 16 16 15 15 15 15 15 15 16 16 15 15 15 15 15 16 16 
15 16 15 15 15 15 15 15 15 15 15 15 15 15 15 15 16 15 15 15 15 15 15 16 16 15 15 15 15 15 15 16 16 16 16 16 16 16 16 16
15 16 15 15 15 15 15 15 15 15 15 15 15 15 15 15 16 16 16 16 16 16 16 16 16 15 15 15 15 15 15 16 16 15 15 15 15 15 16 16 
15 16 15 15 15 15 15 15 15 15 15 15 15 15 15 15 16 16 15 15 15 15 16 16 16 15 15 15 15 15 15 16 16 15 15 15 15 15 16 16  
15 16 15 15 15 15 15 15 15 15 15 15 15 15 15 15 16 16 15 15 15 15 16 16 16 15 15 15 15 15 15 16 16 15 15 15 15 15 16 16 
15 16 15 15 15 15 15 15 15 15 15 15 15 15 15 15 16 16 15 15 15 15 16 16 16 15 15 16 16 15 15 16 16 15 15 15 15 15 16 16 
16 16 16 16 16 16 16 16 16 16 16 16 16 16 16 16 16 16 16 16 16 16 16 16 16 16 16 16 16 16 16 16 16 16 16 16 16 16 16 16 
15 16  0  0  0  0 16  0  0  0 16  0  0  0 16  0  0  0  0  0  0  0  0  0  0  0  0 16 16  0  0  0  0  0  0  0  0  0  0  0  
15 16  0  0  0  0 16  0  0  0 16  0  0  0 16  0  0  0  0  0  0  0  0  0  0  0  0 16 16  0  0  0  0  0  0  0  0  0  0  0   
15 16  0  0  0  0 16  0  0  0 16  0  0  0 16  0  0  0  0  0  0  0  0  0  0  0  0 16 16  0  0  0  0  0  0  0  0  0  0  0   
15 16 16 16 16 16 16 16 16 16 16 16 16 16 16 16 16 16 16 16 16 16 16 16 16 16 16 16 16  0  0  0  0  0  0  0  0  0  0  0   
15 16  0  0  0  0 16  0  0  0 16  0  0  0 16  0  0  0  0  0  0  0  0  0  0  0  0 16 16  0  0  0  0  0  0  0  0  0  0  0   
15 16  0  0  0  0 16  0  0  0 16  0  0  0 16  0  0  0  0  0  0  0  0  0  0  0  0 16 16  0  0  0  0  0  0  0  0  0  0  0   
15 16  0  0  0  0 16  0  0  0 16  0  0  0 16  0  0  0  0  0  0  0  0  0  0  0  0 16 16  0  0  0  0  0  0  0  0  0  0  0   
16 16 16 16 16 16 16 16 16 16 16 16 16 16 16 16 16 16 16 16 16 16 16 16 16 16 16 16 16 16 16 16 16 16 16 16 16 16 16 16  
 1 16  0  0  0  0  0  0  0  0  0  0  0  0  0  0  0  0  0  0  0  0  0  0  0  0  0  0  0  0  0  0  0  0  0  0  0  0  0  0 
